32,32@
11111111111111111111111111111111;
11111111111111111111111111111111;
11111111111111111111111111111111;
11111111111111111111111111111111;
11131113333333111131111113111111;
11131113111113111131111131111111;
11131113111113111131111131111111;
11131113111113111131111131111111;
11131113111113111131111131111111;
11131113111113111131111131111111;
11131113111113111131111131111111;
11131113333333111131111131111111;
11131113111111111111111131111111;
11111111111111111111111131111111;
11111111111111111111111111111111;
11111111111111111111111111111111;
11111111111111111111111111111111;
11111133331111111111111131111111;
11113311131111111111111111111111;
11113111131111111111111111111111;
11113311333333333333111111111111;
11113333311111111313331111111111;
11331131111111111311133111111111;
13333131111111113333333111111111;
33113331111111113111331111111111;
31111131111111333333111111111111;
31111133333333111111111111111111;
33111131111111111111111111111111;
11333331111111111111111111111111;
11113311111111111111111111111111;
11111111111111111111111111111111;
11111111111111111111111111111111;
$